11111111111111111111111
1E0001CCCCCCCCCCCCCCCC1
11100100001100001010011
10000100101100100110011
1000000P0000C0100000001
1000000000C001111110001
10000100000001000000001
1CCCC1CCCCCC11000000001
11111111111111111111111