1111111111111111111111111111111111111111
1E00001000000000000000ZZZZZZZZZZZZZZZZZ1
1000001000000000000000000000000000000001
1CCCC000ZZZZZZZZZZZZZZZZZZZZZZZZZZZZZZZ1
10000000ZZZZZZZZZZZZZZZZZZZZZZZZZZZZZZZ1
10000P01ZZZZZZZZZZZZZZZZZZZZZZZZZZZZZZZ1
10000001ZZZZZZZZZZZZZZZZZZZZZZZZZZZZZZZ1
1C000001ZZZZZZZZZZZZZZZZZZZZZZZZZZZZZZZ1
1111111111111111111111111111111111111111
