



11111111111111111111111
1E000100000000000000001
11100100001100001010011
10000100101100111110011
1P000000000000100000001
1000000C0000000000Z0001
10000100000001000000001
10000100000011100000001
10000100000011100000001
11111111111111111111111





