1111111111111111111111111111
1E00001000000000000000ZZZZZ1
1000001000000000000000000001
1CCCCCC0ZZZZZZZZZZZZZZZZZZZ1
10000001ZZZZZZZZZZZZZZZZZZZ1
10000P01ZZZZZZZZZZZZZZZZZZZ1
10000001ZZZZZZZZZZZZZZZZZZZ1
1C000001ZZZZZZZZZZZZZZZZZZZ1
1111111111111111111111111111
