1111111111111111111111111111111111111111
1E00001000000000000000000000000000000001
1000001000000000000000000000000000000001
1CCCCCC000000000000000000000000000000001
1000000100000000000000000000000000000001
10000P0111111111111111111111111111110001
10000001ZZZZZZZZZ00000ZZZZZZZZZZZZZZZZZ1
1C000001ZZZZZZZZZZZZZZZZZZZZZZZZZZZZZZZ1
1111111111111111111111111111111111111111
