
1111111111111111111
1E000100000Z0000001
1110010000110010011
1P000C0010000010011
1000000010000010E11
1000000010000010Z11
1111111111111111111



