1111111111111111111111111111111111111111
1EZZZ1CCCCCCCCCCCCCCCCZZZZZZZZZZZZZZZZZ1
111ZZ1ZZZZ11ZZZZ1Z1ZZ1ZZZZZZZZZZZZZZZZ11
1ZZZZ1ZZ1Z11ZZ1ZZ11ZZ1ZZZZZZZZZZZZZZZ1Z1
1ZZZZZZZZZZZCZ1ZZZZZZZZZZZZZZZZZZZZZ1ZZ1
1ZZZZZZZZZCZZ111111111ZZZZZZZZZZZZZ1ZZZ1
1ZZZZ1ZZZZZZZ1ZZZZZZZZZZZZZZZZZZZZZZZZZ1
1CCCC1CCCCCC11ZZZZZZZZZZZZZZZZZZZZZZZZZ1
1ZZZZZZZZZZZZZZZZZZZZZZZZZZZZZZZZZZZZZZ1
1ZZZZZZZZZZZZZZZZZZZZZZZZZZZZZZZZZZZZZZ1
1ZZZZZZZZZZZZZZZZZZZZZZZZZZZZZZZZZZZZZZ1
1ZZZZZZZZZZZZZZZZZZZZZZZZZZZZZZZZZZZZZZ1
1ZZZZZZZZZZZZZZZZZZZZZZZZZZZZZZZZZZZZZZ1
1ZZZZZZZZZZZZZZZZZZZZZZZZZZZZZZZZZZZZZZ1
1ZZZZZZZZZZZZZZZZZZZZZZZZZZZZZZZZZZZZZZ1
1ZZZZZZZZZZZZZZZZZZZZZZZZZZZZZZZZZZZZZZ1
1ZZZZZZZZZZZZZZZZZZZZZZZZZZZZZZZZZZZZZZ1
1CCCCCCCZZZZZZZZZZZZZZZZZZZZZZZZZZZZZZZ1
10000001ZZZZZZZZZZZZZZZZZZZZZZZZZZZZZZZ1
10000P01ZZZZZZZZZZZZZZZZZZZZZZZZZZZZZZZ1
10000001ZZZZZZZZZZZZZZZZZZZZZZZZZZZZZZZ1
1C000001ZZZZZZZZZZZZZZZZZZZZZZZZZZZZZZZ1
1111111111111111111111111111111111111111
