1111111111111111111111111111111111111111
1E0001CCCCCCCCCCCCCCCC000000000000000001
1110010000110000101001000000000000000011
1000010010110010011001000000000000000101
100000000000C010000000000000000000001001
1000000000C00111111111000000000000010001
10000100000001000Z0000000000000000000001
1CCCC1CCCCCC1100000000000000000000000001
1000000000000000000000000000000000000001
1000000000000000000000000000000000000001
1000000000000000000000000000000000000001
1000000000000000000000000000000000000001
1000000000000000000000000000000000000001
1000000000000000000000000000000000000001
1000000000000000000000000000000000000001
1000000000000000000000000000000000000001
1000000000000000000000000000000000000001
1000000000000000000000000000000000000001
1000000100000000000000000000000000000001
10000P0100000000000000000000000000000001
1000000100000000000000000000000000000001
1C00000000000000000000000000000000000001
1111111111111111111111111111111111111111
